{
    "mapdata" : [
                 "f0","f0","f0","f0","f0","f0","f0","f0","f0","f0","f0","f0","f0","f0","f0","f0","f0","f0","f0","f0","f0","f0","f0","f0","f0","f0","f0","f0","f0","f0","f0",
                 "f0","f0","f0","f0","f0","f0","f0","f0","f0","f0","f0","f0","f0","f0","f0","f0","f0","f0","f0","f0","f0","f0","f0","f0","f0","f0","f0","f0","f0","f0","f0",
                 "f0","f0","f0","f0","f0","f0","f0","f0","f0","f0","f0","f0","f0","f0","f0","f0","f0","f0","f0","f0","f0","f0","f0","f0","f0","f0","f0","f0","f0","f0","f0",
                 "f0","f0","f0","f0","f0","f0","f0","f0","f0","f0","f0","f0","f0","f0","f0","f0","f0","f0","f0","f0","f0","f0","f0","f0","f0","f0","f0","f0","f0","f0","f0",
                 "f0","f0","f0","f0","f0","f0","f0","f0","f0","f0","f0","f0","f0","f0","f0","f0","f0","f0","f0","f0","f0","f0","f0","f0","f0","f0","f0","f0","f0","f0","f0",
                 "f0","f0","f0","f0","f0","f0","f0","f0","f0","f0","f0","f0","f0","f0","f0","f0","f0","f0","f0","f0","f0","f0","f0","f0","f0","f0","f0","f0","f0","f0","f0",
                 "f0","f0","f0","f0","f0","f0","f0","f0","f0","f0","f0","f0","f0","f0","f0","f0","f0","f0","f0","f0","f0","f0","f0","f0","f0","f0","f0","f0","f0","f0","f0",
                 "f0","f0","f0","f0","f0","f0","f0","f0","f0","f0","f0","f0","f0","f0","f0","f0","f0","f0","f0","f0","f0","f0","f0","f0","f0","f0","f0","f0","f0","f0","f0",
                 "f0","f0","f0","f0","f0","f0","f0","f0","f0","f0","f0","f0","f0","f0","f0","f0","f0","f0","f0","f0","f0","f0","f0","f0","f0","f0","f0","f0","f0","f0","f0",
                 "f0","f0","f0","f0","f0","f0","f0","f0","f0","f0","f0","f0","f0","f0","f0","f0","f0","f0","f0","f0","f0","f0","f0","f0","f0","f0","f0","f0","f0","f0","f0",
                 "f0","f0","f0","f0","f0","f0","f0","f0","f0","f0","f0","f0","f0","f0","f0","f0","f0","f0","f0","f0","f0","f0","f0","f0","f0","f0","f0","f0","f0","f0","f0",
                 "f0","f0","f0","f0","f0","f0","f0","f0","f0","f0","f0","f0","f0","f0","f0","f0","f0","f0","f0","f0","f0","f0","f0","f0","f0","f0","f0","f0","f0","f0","f0",
                 "f0","f0","f0","f0","f0","f0","f0","f0","f0","f0","f0","f0","f0","f0","f0","f0","f0","f0","f0","f0","f0","f0","f0","f0","f0","f0","f0","f0","f0","f0","f0",
                 "f0","f0","f0","f0","f0","f0","f0","f0","f0","f0","f0","f0","f0","f0","f0","f0","f0","f0","f0","f0","f0","f0","f0","f0","f0","f0","f0","f0","f0","f0","f0",
                 "f0","f0","f0","f0","f0","f0","f0","f0","f0","f0","f0","f0","f0","f0","f0","f0","s0","f0","f0","f0","f0","f0","f0","f0","f0","f0","f0","f0","f0","f0","f0",
                 "f0","f0","f0","f0","f0","f0","f0","f0","f0","f0","f0","f0","f0","f0","f0","f0","f0","f0","f0","f0","f0","f0","f0","f0","f0","f0","f0","f0","f0","f0","f0",
                 "f0","f0","f0","f0","f0","f0","f0","f0","f0","f0","f0","f0","f0","f0","f0","f0","f0","f0","f0","f0","f0","f0","f0","f0","f0","f0","f0","f0","f0","f0","f0",
                 "f0","f0","f0","f0","f0","f0","f0","f0","f0","f0","f0","f0","f0","f0","f0","f0","f0","f0","f0","f0","f0","f0","f0","f0","f0","f0","f0","f0","f0","f0","f0",
                 "f0","f0","f0","f0","f0","f0","f0","f0","f0","f0","f0","f0","f0","f0","f0","f0","f0","f0","f0","f0","f0","f0","f0","f0","f0","f0","f0","f0","f0","f0","f0",
                 "f0","f0","f0","f0","f0","f0","f0","f0","f0","f0","f0","f0","f0","f0","f0","f0","f0","f0","fe","f0","f0","f0","f0","f0","f0","f0","f0","f0","f0","f0","f0",
                 "f0","f0","f0","f0","f0","f0","f0","f0","f0","f0","f0","f0","f0","f0","f0","f0","f0","f0","f0","f0","f0","f0","f0","f0","f0","f0","f0","f0","f0","f0","f0",
                 "f0","f0","f0","f0","f0","f0","f0","f0","f0","f0","f0","f0","f0","f0","f0","f0","fe","f0","f0","f0","f0","f0","f0","f0","f0","f0","f0","f0","f0","f0","f0"
                
                ] ,
    "mapdims" : { "x":31,"y":22 }
}