{
    "mapdata" : [
                 "l4","l4","l4","l5","fx","fx","w2","w0","w0","w0","w0","w0","w0","w0","w0","w0","w1","fd","l4","l4","l7","l7","l7","l7","l7","l7","l7","l4","l4","l4","l4",
                 "l4","l4","l4","l5","f0","f0","f0","f0","f0","f0","f0","f0","f0","f0","s0","w2","w1","l6","l7","fb","w3","f0","w2","w0","w1","f0","w3","fa","l4","l4","l4",
                 "l4","l4","l4","fb","f0","f0","f0","f0","w2","w0","w0","w1","f0","f0","f0","f0","f0","f0","f0","f0","f0","f0","f0","w2","w1","f0","f0","w3","l6","l4","l4",
                 "l4","l4","l4","fc","w2","w1","w2","w0","w0","w0","w0","w0","w0","w0","w1","f0","w2","w0","w1","f0","f0","f0","f0","w2","w1","f0","f0","f0","f0","l6","l4",
                 "l4","l4","l4","l4","fc","fd","l1","l1","l1","l1","l1","l2","w2","w0","w0","w0","w0","w0","w0","w0","w1","f0","f0","w3","f0","f0","w3","f0","f0","w3","l3",
                 "l4","l4","l4","l7","l7","l7","l7","l7","l4","l4","l4","l4","l1","fc","w2","w0","w1","w2","w0","w0","w1","f0","f0","f0","f0","w2","w0","w1","f0","f0","l3",
                 "l4","l4","fb","w3","f0","f0","f0","w3","fa","l7","l4","l4","l4","l5","w2","w1","f0","f0","w2","w0","w0","w1","f0","f0","w2","w0","w0","w1","f0","f0","fa",
                 "l4","l5","w2","w1","f0","f0","f0","f0","f0","f0","fa","l7","l7","l8","w3","f0","f0","f0","f0","f0","w2","w0","w0","w0","w0","w1","f0","f0","f0","w2","w0",
                 "l4","fb","w3","f0","f0","f0","f0","f0","f0","f0","f0","w2","w0","w0","w1","f0","f0","f0","w3","f0","f0","w2","w0","w0","w1","f0","f0","f0","w2","w1","fd",
                 "l5","w3","f0","s0","w3","f0","f1","f2","f0","f0","f0","f0","w2","w1","f0","f0","f0","f0","f0","w3","f0","f0","w2","w1","s0","f0","f0","w2","w0","w1","l6",
                 "l5","f0","f0","f0","f0","f0","f0","f0","f0","w3","f0","f0","f0","f0","f0","f0","f0","s0","f0","f0","f0","w2","w1","f0","f0","f0","f0","f0","w2","w0","w0",
                 "l4","fc","f0","w3","f0","f1","f2","f0","f0","f0","f0","f0","f0","f0","f0","f0","f0","f0","f0","f0","f0","f0","w3","f0","f0","f0","f0","w2","w0","w0","w0",
                 "l4","l4","fc","f0","f0","f0","f0","f0","w2","w1","f0","f0","f0","f0","f0","f0","f0","f0","f0","f0","f0","w2","w1","f0","f0","f0","w2","w0","w1","f0","fd",
                 "l4","l7","l8","f0","f0","f0","f0","f0","w2","w0","w1","f0","f0","f0","f0","f0","f0","f0","f0","f0","f0","w2","w0","w1","f0","f0","w2","w0","w1","f0","l3",
                 "l5","f0","f0","f0","f0","f0","w2","w0","w0","w0","w0","w1","f0","f0","f0","f0","w2","w1","f0","f0","f0","w2","w0","w0","w1","f0","f0","w2","w0","w1","l3",
                 "l5","f0","f0","f0","f0","f0","f0","f0","f0","w2","w1","f0","f0","f0","f0","w2","w1","f0","f0","f0","f0","w2","w0","w0","w1","f0","f0","f0","w2","w1","l3",
                 "l4","fc","f0","f0","f0","f0","f0","f0","f0","f0","f0","f0","f0","w2","w0","w1","f0","w3","f0","f0","f0","f0","w2","w0","w1","f0","f0","f0","f0","l0","l4",
                 "l4","l5","w2","w1","f0","f0","f0","f0","w2","w0","w0","w0","w0","w1","f0","w2","w1","fd","l1","fc","f0","f0","f0","f0","w2","w1","f0","w3","f0","l6","l4",
                 "l4","l4","fc","w2","w1","f0","f0","f0","f0","f0","w2","w1","fe","w2","w0","w0","w1","l3","l4","l5","f0","w2","w1","f0","f0","w2","w0","w1","f0","f0","l3",
                 "l4","l4","l4","l5","w2","w0","w1","f0","f0","f0","f0","f0","f0","f0","f0","w2","w1","l3","l4","l5","w2","w0","w0","w1","f0","f0","w3","f0","f0","f0","l3",
                 "l4","l4","l4","l4","l1","l1","l1","l1","l1","l1","l1","l1","l1","l2","w2","w1","fd","l4","l4","l4","fc","w2","w0","w0","w1","f0","f0","f0","fd","l1","l4",
                 "l4","l4","l4","l4","l4","l4","l4","l4","l4","l4","l4","l4","l4","l4","l1","l1","l4","l4","l4","l4","l4","l1","l1","l1","l1","l1","l1","l1","l4","l4","l4"
                ] ,
    "mapdims" : { "x":31,"y":22 }
}
