{
    "mapdata" : [
                 "w0","w0","w0","w1","c0","c1","w2","w0","w0","w0","w0","w0","w0","w0","w0","w0","w0","w0","w0","w0","w0","w0","w0","w0","w0","w0","w0","w0","w0","w0",
                 "w1","f0","f0","f0","c2","c3","f0","f0","f0","f0","f0","f0","f0","f0","f0","w2","w0","w1","f0","f0","w3","f0","w2","w0","w1","f0","w2","w0","w0","w0",
                 "w0","w1","f0","f0","f0","f0","f0","f0","w2","w0","w0","w1","f0","w3","f0","f0","f0","f0","f0","f0","f0","f0","f0","w2","w1","f0","f0","w2","w0","w0",
                 "w0","w0","w0","w1","w2","w0","w0","w0","w0","w0","w0","w0","w0","w0","w1","f0","w2","w0","w1","f0","f0","f0","f0","w2","w1","f0","f0","f0","w2","w0",
                 "w0","w0","w0","w0","w0","w0","w0","w1","l0","l1","l1","l1","l2","w2","w0","w0","w0","w0","w0","w0","w1","f0","f0","w3","f0","f0","w3","f0","f0","w2",
                 "w0","w0","w0","w0","w1","f0","w2","w1","l3","l4","l4","l4","l5","f0","f0","f0","f0","w2","w0","w0","w1","f0","f0","f0","f0","w2","w0","w1","f0","w2",
                 "l1","l2","w2","w1","f0","f0","f0","w3","fa","l7","l4","l4","l5","w2","w1","f0","f0","f0","w2","w0","w0","w1","f0","f0","w2","w0","w0","w1","f0","w2",
                 "l4","l5","w2","w1","f0","f0","f0","f0","f0","f0","fa","l7","l8","w2","w1","f0","f0","f0","f0","f0","w2","w0","w0","w0","w0","w1","f0","f0","f0","w2",
                 "l4","fb","w3","f0","f0","f0","f0","f0","f0","f0","f0","w2","w0","w0","w1","f0","f0","f0","w3","f0","f0","w2","w0","w0","w1","f0","f0","f0","w2","w0",
                 "l5","w3","f0","f0","w3","f0","f1","f2","f0","f0","f0","f0","w2","w1","f0","f0","f0","f0","f0","w3","f0","f0","w2","w1","f0","f0","f0","w2","w0","w0",
                 "l5","f0","f0","f0","f0","f0","f0","f0","f0","w3","f0","f0","f0","f0","f0","f0","f0","f0","f0","f0","f0","w2","w1","f0","f0","f0","f0","f0","w2","w0",
                 "l5","f0","f0","f0","f0","f0","f0","f0","f0","f0","f0","f0","f0","f0","f0","w3","f0","f0","f0","f0","f0","f0","w3","f0","f0","f0","f0","w2","w0","w0",
                 "l5","f0","f0","f0","f0","f0","f0","f0","w2","w1","f0","f0","f0","f0","f0","f0","f0","f0","f0","f0","f0","w2","w1","f0","f0","f0","w2","w0","w1","f1",
                 "l5","f0","w3","f0","f0","f0","f0","f0","w2","w0","w1","f0","f0","f0","f0","f0","f0","f0","f0","f0","f0","w2","w0","w1","f0","f0","w2","w0","w0","w0",
                 "l5","f0","f0","f0","f0","f0","w2","w0","w0","w0","w0","w1","f0","f0","f0","f0","w2","w1","f1","f2","f0","w2","w0","w0","w1","f0","f0","w2","w0","w0",
                 "l5","f0","f0","f0","f0","f0","f0","f0","f0","w2","w0","w0","w1","f0","f0","w2","w1","f0","f0","f0","f0","w2","w0","w0","w1","f0","f0","f0","w2","w0",
                 "l4","fc","f0","f0","f0","f0","f0","f0","f0","f0","w2","w0","w0","w0","w0","w1","f0","w3","f0","f0","f0","f0","w2","w0","w1","f0","f0","f0","f0","w2",
                 "l4","l5","w2","w1","f0","f0","f0","f0","w2","w0","w0","w0","w0","w0","w0","w0","w0","w1","f0","f0","f0","f0","f0","f0","w2","w1","f0","w3","f0","w2",
                 "l4","l4","fc","w2","w1","f0","f0","f0","f0","f0","w2","w1","fe","w2","w0","w0","w0","w0","w1","f0","f0","w2","w1","f0","f0","w2","w0","w1","f0","w2",
                 "l4","l4","l4","fc","w2","w0","w0","w1","f0","f0","f0","f0","f0","f0","f0","w2","w1","f0","f0","f0","w2","w0","w0","w1","f0","f0","w3","f0","f0","w2",
                 "l4","l4","l4","l5","w2","w0","w0","w0","w0","w0","w1","f0","f0","f0","w2","w0","w0","w0","w0","w0","w0","w0","w0","w0","w1","f0","f0","f0","w2","w0",
                 "l4","l4","l4","l4","l1","l1","l1","l1","l1","l1","l1","l1","l1","l1","l1","l1","l1","l1","l1","l1","l1","l1","l1","l1","l1","l1","l1","l1","l1","l1"
                ] ,
    "mapdims" : { "x":30,"y":22 }
}
