{
    "mapdata" : [
                 "w0","w0","w0","w1","fe","w2","w0","w0","w0","w0","w0","w0","w0","w0","w0","w0",
                 "w1","f0","f0","f0","f0","f0","f0","f0","f0","f0","f0","f0","f0","f0","f0","w2",
                 "w0","w1","f0","f0","f0","f0","f0","f0","w2","w0","w0","w1","f0","f0","f0","w2",
                 "w0","w1","f0","f0","f0","f0","w2","w0","w0","w0","w0","w0","w0","w0","w0","w0",
                 "w0","w0","w1","f0","f0","w2","w0","w1","l0","l1","l1","l1","l2","w2","w0","w0",
                 "w0","w0","w0","w1","f0","f0","w2","w1","l3","l4","l4","l4","l5","w2","w0","w0",
                 "w0","w0","w0","w1","f0","f0","f0","w3","l3","l4","l4","l4","l5","w2","w0","w0",
                 "w0","w0","w0","w1","f0","f0","f0","f0","l6","l7","l7","l7","l8","w2","w0","w0",
                 "w0","w0","w1","f0","f0","f0","f0","f0","f0","f0","f0","w2","w0","w0","w0","w0",
                 "w0","w1","f0","f0","f0","f0","f0","f0","f0","f0","f0","f0","w2","w0","w0","w0",
                 "w1","f0","f0","f0","f0","f0","f0","f0","f0","f0","f0","f0","f0","f0","w2","w0",
                 "w1","f0","f0","f0","f0","f0","f0","f0","f0","f0","f0","f0","f0","f0","f0","w2",
                 "w1","f0","f0","f0","f0","f0","f0","f0","w2","w1","f0","f0","f0","f0","f0","w2",
                 "w1","f0","w3","f0","f0","f0","f0","f0","w2","w0","w1","f0","f0","f0","f0","w2",
                 "w1","f0","f0","f0","f0","f0","w2","w0","w0","w0","w0","w1","f0","f0","f0","w2",
                 "w1","f0","f0","f0","w3","f0","f0","f0","f0","w2","w0","w0","w0","w1","f0","w2",
                 "w0","w1","f0","f0","f0","f0","f0","f0","f0","f0","w2","w0","w0","w1","f0","w2",
                 "w0","w0","w0","w1","f0","f0","f0","f0","w2","w0","w0","w0","w0","w1","f0","w2",
                 "w0","w0","w0","w0","w1","f0","f0","f0","f0","f0","w2","w1","f0","w3","f0","w2",
                 "w0","w0","w0","w0","w0","w0","w0","w1","f0","f0","f0","f0","f0","f0","f0","w2",
                 "w0","w0","w0","w0","w0","w0","w0","w0","w0","w0","w1","f0","f0","w2","w0","w0"
                ] ,
    "mapdims" : { "x":16,"y":21 }
}
