{
    "mapdata" : [
                 "w1","f0","f0","w2","w0","w0","w0","w0","w0","w0","w0","w0","w0","w0","w0","w0","w0","w0","w0","w0","w0","w0","w0","w1","l3","l4","l4","l4","l4","l4","l4",
                 "w1","f0","f0","f0","f0","f0","f0","f0","f0","f0","f0","f0","f0","f0","f0","f0","w2","w0","w0","w0","w0","w1","f0","f0","f0","l3","l4","l4","l4","l4","l4",
                 "w1","s4","f0","f0","f0","f0","f0","l0","l2","f0","f0","f0","f0","f0","f0","f0","f0","w2","w0","w0","w1","f0","f0","s4","f0","l3","l4","l4","l4","l4","l4",
                 "w1","f0","f0","f0","l0","l1","l1","l4","l4","l2","f0","f0","f0","w3","f0","f0","f0","f0","f0","w3","f0","f0","f0","f0","f0","l3","l4","l4","l4","l4","l4",
                 "w1","f0","l0","l1","l4","l7","l7","l8","fa","fb","f0","f0","w2","w1","f0","f0","f0","f0","f0","f0","f0","f0","f0","f0","l3","l4","l4","l4","l4","l4","l4",
                 "w1","l0","l4","l4","l8","f0","f0","f0","f0","f0","f0","f0","w2","w0","w0","w0","w1","f0","f0","f0","f0","f0","f0","l3","l4","l4","l4","l4","l4","l4","l4",
                 "l1","l4","l4","l8","f0","f0","f0","f0","f0","f0","f0","f0","w2","w0","w0","w0","w0","w0","w0","w0","w1","f0","l3","l4","l4","l4","l4","l4","l4","l4","l4",
                 "l4","l4","l8","f0","f0","f0","f0","f0","f0","w2","w0","w0","w0","w0","w0","w0","w0","w0","w0","w1","l3","l4","l4","l4","l4","l4","l4","l4","l4","l4","l4",
                 "l4","l5","f0","f0","f0","f0","f0","w2","w0","w0","w1","f0","f0","f0","f0","f0","f0","w2","w1","l3","l4","l4","l4","l4","l4","l4","l4","l4","l4","l4","l4",
                 "l4","l5","f0","f0","f0","f0","f0","w2","w1","f0","f0","f0","f0","f0","f0","f0","s0","f0","s0","l3","l4","l4","l4","l4","l4","l4","l4","l4","l4","l4","l4",
                 "l4","fb","f0","f0","f0","f0","w2","w0","w1","f0","f0","f0","f0","f0","s0","f0","f0","f0","f0","l3","l4","l4","l4","l4","l4","l4","l4","l4","l4","l4","l4",
                 "w1","f0","f0","f0","f0","w2","w1","f0","f0","f0","f0","f0","w2","w1","f0","f0","f0","f0","f0","l3","l4","l4","l4","l4","l4","l4","l4","l4","l4","l4","l4",
                 "w1","f0","f0","f0","f0","w3","f0","f0","f0","f0","f0","w2","w1","s0","f0","f0","f0","f0","f0","f0","l3","l4","l4","l4","l4","l4","l4","l4","l4","l4","l4",
                 "w1","f0","f0","f0","f0","f0","f0","f0","f0","f0","w2","w0","w1","f0","f0","f0","f0","f0","f0","f0","f0","f0","l3","l4","l4","l4","l4","l4","l4","l4","l4",
                 "w0","f0","f0","f0","f0","f0","f0","f0","f0","f0","w2","w0","w1","f0","f0","f0","f0","f0","f0","f0","f0","f0","f0","l3","l4","l4","l4","l4","l4","l4","l4",
                 "w0","f0","f0","f0","f0","f0","f0","f0","w2","w0","w0","w0","w0","w1","f0","f0","f0","f0","f0","f0","f0","f0","f0","f0","l3","l4","l4","l4","l4","l4","l4",
                 "w0","w1","f0","f0","f0","f0","w2","w0","w0","w0","w0","w0","w0","w0","w1","f0","f0","f0","f0","f0","f0","f0","f0","f0","l3","l4","l4","l4","l4","l4","l4",
                 "w0","w1","w1","w2","w0","w0","w0","w0","w0","w0","w0","w0","w0","w0","w0","w1","f0","f0","f0","f0","f0","f0","f0","f0","l3","l4","l4","l4","l4","l4","l4",
                 "w0","w0","w0","w0","w0","w0","w0","w0","w0","w0","w0","w0","w0","w0","w0","w0","w0","w1","f0","f0","w2","w0","w1","l3","l4","l4","l4","l4","l4","l4","l4",
                 "w0","w0","w0","w0","w0","w0","w0","w0","w0","w0","w0","w0","w0","w0","w0","w0","w0","w1","fe","f0","w2","w1","f0","l3","l4","l4","l4","l4","l7","l7","l4",
                 "w0","w0","w0","w0","w0","w0","w0","w0","w0","w0","w0","w0","w0","w0","w0","w0","w0","w1","d2","d3","w2","w1","l0","l4","l4","l4","l7","l8","f0","f0","l3",
                 "w0","w0","w0","w0","w0","w0","w0","w0","w0","w0","w0","w0","w0","w0","w0","w0","w1","f0","d4","d5","w3","l0","l4","l4","l4","l8","w3","f0","f0","f0","l3"
                
                ] ,
    "mapdims" : { "x":31,"y":22 }
}