{
        "mapdata" : [
"w0","w0","w0","w0","w0","w0","w0","w0","w0","w0","w0","w0","w0","w0","w0","w0","w0","w1","f0","f0","f0","f0","f0","f0","f0","f0","f0","f0","w0","w0","w0",
"fx","f0","f0","f0","f0","w0","w0","w0","w0","w0","w0","w1","f0","w3","f0","f0","f0","w2","w1","f0","f0","f0","f0","f0","f0","f0","f0","f0","w0","w0","w0",
"fx","s4","f0","f0","f0","f0","w0","w0","w0","w0","w0","w1","f0","f0","f0","f0","f0","w2","w1","f0","f0","f0","f0","f0","f0","f0","f0","w0","w0","w0","w0",
"fx","f0","f0","f0","f0","f0","f0","f0","f0","f0","w2","w1","f0","w2","w0","w1","f0","w2","w0","w0","w0","w1","f0","f0","f0","f0","f0","w0","w0","w0","w0",
"w0","w0","w1","f0","f0","f0","f0","f0","f0","f0","f0","w3","f0","f0","f0","w3","f0","f0","w3","f0","w2","w0","w1","f0","f0","f0","w0","w0","w0","w0","w0",
"w0","w0","w0","w0","w0","w0","w0","w0","w1","f0","f0","w2","w0","w1","f0","w3","f0","f0","f0","f0","f0","f0","w2","w0","w1","f0","w0","w0","w0","w0","w0",
"w0","w0","w0","w0","w1","f0","f0","w2","w0","w1","f0","f0","f0","w3","f0","w2","w1","f0","f0","w2","w1","f0","f0","w2","w0","w0","w0","w0","w0","w0","w0",
"w0","w0","w1","f0","f0","f0","f0","f0","f0","w2","w0","w1","f0","f0","f0","f0","w2","w0","w0","w1","f0","f0","f0","f0","f0","f0","w0","w0","w0","w0","w0",
"w0","w1","f0","f0","f0","f0","f0","f0","f0","f0","f0","w2","w1","f0","f0","f0","w2","w1","f0","f0","f0","f0","f0","f0","f0","f0","w0","w0","w0","w0","w0",
"w1","f0","f0","f0","f0","f0","f0","f0","f0","f0","f0","f0","w2","w1","f0","w2","w1","f0","f0","f0","f0","f0","f0","f0","f0","f0","f0","w0","w0","w0","w0",
"w1","f0","f0","f0","f0","f0","f0","f0","f0","f0","f0","f0","f0","w2","w0","w0","w1","f0","f0","f0","f0","f0","f0","f0","f0","f0","f0","f0","w0","w0","w0",
"w1","f0","f0","w2","w1","f0","f0","f0","w3","f0","w3","f0","f0","w2","w1","f0","f0","f0","f0","s1","f0","f0","s1","f0","f0","f0","f0","f0","f0","w0","w0",
"w1","f0","f0","f0","w2","w1","f0","f0","f0","f0","f0","f0","f0","w3","f0","f0","f0","f0","f0","f0","f0","f0","f0","f0","f0","f0","f0","l4","l4","l4","l4",
"w0","w1","f0","f0","f0","w2","w1","f0","f0","f0","f0","f0","f0","w3","f0","f0","f0","f0","f0","f0","f0","f0","f0","f0","f0","f0","l4","l4","l4","l4","l4",
"w0","w1","f0","f0","f0","w2","w1","f0","f0","w2","w1","f0","w2","w1","f0","f0","f0","f0","f0","f0","f0","f0","f0","f0","f0","f0","l3","l4","l4","l4","l4",
"w0","w1","f0","f0","f0","f0","w2","w1","f0","f0","w3","f0","w2","w1","f0","f0","s1","f0","f0","f0","f0","f0","f0","f0","f0","f0","l3","l4","l4","l4","l4",
"w0","w1","f0","f0","f0","f0","w2","w1","f0","f0","w3","w2","w0","w1","f0","f0","f0","f0","f0","f0","f0","f0","f0","f0","f0","f0","l3","l4","l4","l4","l4",
"w0","w0","w0","w1","f0","f0","w2","w1","f0","f0","w2","w0","w1","f0","f0","f0","f0","f0","s1","f0","f0","s1","f0","f0","f0","l3","l4","l4","l4","l4","l4",
"w0","w0","w1","f0","f0","f0","w2","w1","f0","f0","f0","f0","f0","f0","f0","f0","f0","f0","f0","f0","f0","f0","f0","f0","f0","l3","l4","l4","l4","l4","l4",
"w0","w1","f0","f0","f0","w2","w0","w0","w1","f0","f0","f0","f0","f0","f0","f0","f0","s1","f0","f0","f0","f0","f0","f0","l3","l4","l4","l4","l4","l4","l4",
"w1","f0","f0","f0","w2","w0","w0","w0","w0","w0","w1","f0","f0","f0","f0","f0","f0","f0","f0","f0","f0","f0","f0","f0","l3","l4","l4","l4","l4","l4","l4",
"w1","f0","fe","w2","w0","w0","w0","w0","w0","w0","w0","w0","w0","w0","w0","w0","w0","w0","w0","w0","w0","w0","w0","w1","l6","l4","l4","l4","l4","l4","l4"
        ] ,
        "mapdims" : { "x":31,"y":22 },
        "npcs": [
                {
                        "type": 6,
                        "x": 1,
                        "y": 14,
                        "says": "Woof!"
                }
        ]
}