{
        "mapdata" : [
"w0","w0","w0","w0","w0","w0","w0","w0","w0","w0","w0","w0","w0","w0","w0","w0","w0","w0","w1","f0","f0","f0","f0","f0","f0","f0","f0","f0","w2","w0","w0",
"fx","f0","f0","f0","w2","w0","w0","w0","w0","w0","w0","w1","f0","w3","f0","f0","w2","w0","w0","w0","w1","f0","f0","f0","f0","f0","f0","f0","w2","w0","w0",
"fx","s4","f0","f0","f0","w2","w0","w0","w0","w0","w0","w1","f0","f0","f0","f0","f0","w2","w0","w0","w0","w1","f0","f0","f0","f0","f0","w2","w0","w0","w0",
"fx","f0","f0","f0","f0","f0","f0","f0","f0","f0","w2","w1","f0","w2","w0","w1","f0","w2","w0","w0","w0","w1","f0","f0","f0","f0","f0","w2","w0","w0","w0",
"w0","w0","w1","f0","f0","f0","f0","f0","f0","f0","w2","w0","w1","f0","f0","w3","f0","f0","w3","f0","w2","w0","w0","w1","f0","f0","w2","w0","w0","w0","w0",
"w0","w0","w0","w0","w0","w0","w0","w0","w1","f0","f0","w2","w0","w1","f0","w2","w1","f0","f0","f0","f0","f0","w2","w0","w0","w0","w0","w0","w0","w0","w0",
"w0","w0","w0","w0","w0","w0","w0","w0","w0","w1","f0","f0","f0","w3","f0","w2","w1","f0","f0","w2","w1","f0","f0","w2","w0","w0","w0","w0","w0","w0","w0",
"w0","w0","w1","f0","f0","f0","f0","f0","w2","w0","w0","w1","f0","f0","f0","f0","w2","w0","w0","w1","f0","f0","f0","f0","f0","f0","w2","w0","w0","w0","w0",
"w0","w1","f0","f0","f0","f0","f0","f0","w3","f0","w2","w0","w1","f0","f0","f0","w2","w1","f0","f0","f0","f0","f0","f0","f0","f0","w2","w0","w0","w0","w0",
"w1","f0","f0","f0","f0","f0","f0","f0","f0","f0","f0","w2","w0","w1","f0","w2","w1","f0","f0","f0","f0","f0","f0","f0","f0","f0","f0","w2","w0","w0","w0",
"w1","f0","f0","f0","f0","f0","f0","f0","f0","f0","f0","f0","w2","w0","w0","w0","w1","f0","f0","f0","f0","ff","fg","s1","f0","f0","f0","f0","w2","w0","w0",
"w1","f0","f0","w2","w1","f0","f0","f0","f0","f0","w3","f0","w2","w0","w1","f0","f0","f0","f0","s1","ff","f4","f4","f7","f7","fg","f0","f0","l0","l2","w2",
"w1","f0","f0","f0","w2","w1","f0","f0","f0","f0","f0","f0","w2","w0","w1","f0","f0","f0","f0","f0","f5","f4","f4","f4","f4","f6","fd","l1","l4","l4","l2",
"w0","w1","f0","f0","f0","w2","w1","f0","f0","f0","f0","f0","w2","w1","f0","f0","f0","f0","ff","f7","f4","f4","f4","f4","f8","fh","l3","l4","l4","l4","l4",
"w0","w1","f0","f0","f0","w2","w1","f0","f0","w2","w1","f0","w2","w1","f0","f0","f0","f0","f5","f4","f4","f4","f4","f6","s1","f0","l3","l4","l4","l4","l4",
"w0","w1","f0","f0","f0","f0","w2","w1","f0","f0","w3","w2","w0","w1","f0","f0","s1","f0","f5","f4","f4","f4","f4","fh","f0","f0","l3","l4","l4","l4","l4",
"w0","w1","f0","f0","f0","f0","w2","w1","f0","f0","w2","w0","w0","w1","f0","f0","f0","ff","f4","f4","f4","f4","f6","f0","f0","fd","l4","l4","l4","l4","l4",
"w0","w0","w0","w1","f0","f0","w2","w1","f0","f0","w2","w0","w1","f0","f0","f0","f0","f9","f8","f4","f4","f4","f6","s1","f0","l3","l4","l4","l4","l4","l4",
"w0","w0","w1","f0","f0","f0","w2","w1","f0","f0","f0","f0","f0","f0","f0","f0","f0","f0","f0","f5","f4","f4","f6","f0","f0","l3","l4","l4","l4","l4","l4",
"w0","w1","f0","f0","f0","w2","w0","w0","w1","f0","f0","f0","f0","f0","f0","f0","f0","s1","f0","f9","f8","f8","fh","f0","l0","l4","l4","l4","l4","l4","l4",
"w1","f0","f0","f0","w2","w0","w0","w0","w0","w0","w1","f0","f0","f0","f0","f0","f0","f0","f0","f0","f0","f0","f0","f0","l3","l4","l4","l4","l4","l4","l4",
"w1","f0","fe","w2","w0","w0","w0","w0","w0","w0","w0","w0","w0","w0","w0","w0","w0","w0","w0","w0","w0","w0","w0","w1","l3","l4","l4","l4","l4","l4","l4"
        ] ,
        "mapdims" : { "x":31,"y":22 },
        "npcs": [
                {
                        "type": 7,
                        "x": 3,
                        "y": 19,
                        "says": "Invasion? What invasion?"
                },
                {
                        "type": 6,
                        "x": 11,
                        "y": 12,
                        "says": "Woof!"
                }
        ]
}