{
        "mapdata" : [
"w0","w0","w0","w0","w0","w0","w0","w0","w0","w0","w0","w0","w0","w0","w0","w0","w0","w0","w0","w0","w1","l3","l5","w2","w0","w0","w0","w0","w0","w0","w0",
"w0","w0","w0","w0","w1","f0","f0","f0","f0","f0","w2","w0","w0","w0","w0","w0","w0","w0","w1","f0","f0","l3","l5","f0","f0","f0","f0","f0","f0","f0","f0",
"w0","w1","c0","c1","f0","f0","f0","f0","f0","w2","w0","w1","f0","w2","w0","w0","w0","w1","f0","f0","f0","f3","f3","f0","f0","f0","f0","f0","f0","f0","fe",
"w0","w1","c2","c3","f0","f0","f0","f0","f0","w2","w1","f0","f0","f0","f0","w2","w1","f0","f0","f0","f0","l3","l5","w2","w0","w1","f0","f0","f0","f0","f0",
"w0","w1","f0","s1","f0","f0","f0","f0","f0","w2","w1","f0","f0","f0","f0","f0","w3","f0","f0","f0","l0","l4","l5","w2","w0","w0","w0","w1","f0","w2","w0",
"w0","w1","f0","f0","f0","f0","f0","f0","f0","f0","w3","s6","f0","w3","l0","l2","f0","f0","f0","f0","l3","l4","l8","f0","f0","w2","w0","w1","f0","w2","w0",
"w0","w0","w1","f0","f0","s1","f0","f0","f0","f0","w3","f0","f0","l0","l4","l4","l2","f0","w3","l0","l4","l5","f0","f0","f0","w2","w1","f0","f0","w2","w0",
"w0","w0","w1","f0","f0","f0","f0","s1","f0","f0","l0","l2","f0","l3","l4","l4","l4","l1","l1","l4","l4","l5","f0","f0","w2","w0","w1","f0","f0","w2","w0",
"w0","w0","w0","w0","w1","f0","f0","f0","f0","f0","l3","l4","l1","l4","l4","l4","l4","l4","l4","l4","l4","l4","l2","f0","w2","w1","f0","f0","f0","w2","w0",
"w0","w0","w0","w0","w0","w0","w1","f0","f0","f0","l3","l4","l4","l4","l4","l4","l4","l4","l4","l4","l4","l4","l5","w2","w0","w1","f0","f0","f0","w2","w1",
"w0","w1","f0","w2","w0","w0","w0","w1","f0","f0","l3","l4","l4","l4","l4","l4","l4","l4","l4","l4","l4","l4","l5","w2","w0","w1","f0","f0","f0","w2","w1",
"w1","f0","f0","f0","w2","w0","w0","w1","f0","f0","l3","l4","l4","l4","l4","l4","l4","l4","l4","l4","l4","l4","l8","w2","w0","w0","w1","f0","w2","w0","w1",
"w1","f0","f0","f0","f0","w2","w1","f0","f0","f0","l3","l4","l4","l4","l4","l4","l4","l4","l4","l4","l4","l8","w2","w0","w0","w0","w0","w1","f0","w2","w1",
"w1","f0","f0","f0","s1","f0","f0","f0","f0","f0","l6","l4","l4","l4","l4","l4","l4","l4","l4","l4","l5","w3","f0","w2","w0","w0","w0","w1","f0","w2","w0",
"w1","f0","f0","f0","f0","f0","f0","f0","f0","f0","w3","l6","l4","l4","l4","l4","l4","l4","l4","l4","l8","f0","f0","f0","w2","w0","w1","f0","f0","w2","w0",
"w1","f0","f0","s1","f0","f0","f0","f0","f0","f0","w2","w1","l6","l4","l4","l4","l4","l4","l7","l8","f0","f0","f0","f0","w2","w0","w1","f0","f0","w2","w0",
"w0","w1","f0","f0","f0","f0","f0","f0","f0","f0","w2","w1","f0","l6","l7","l7","l7","l8","f0","f0","f0","f0","f0","f0","w2","w1","f0","f0","f0","w2","w0",
"w0","w1","f0","f0","f0","f0","f0","f0","f0","f0","w3","f0","f0","f0","f0","f0","f0","f0","f0","s1","f0","f0","f0","f0","w2","w1","f0","f0","w2","w0","w0",
"w0","w0","w1","f0","s1","f0","f0","f0","f0","f0","f0","f0","f0","f0","f0","f0","f0","s1","f0","f0","f0","f0","f0","f0","f0","f0","w2","w0","w0","w0","w0",
"w0","w0","w0","w1","f0","f0","f0","f0","w2","w0","w0","w0","w0","w1","f0","f0","f0","f0","f0","f0","f0","f0","f0","f0","w2","w0","w0","w0","w0","w0","w0",
"w0","w0","w0","w0","w0","w1","f0","w2","w0","w0","w0","w0","w0","w0","w0","w0","w1","s1","f0","f0","f0","s6","f0","w2","w0","w0","w0","w0","w0","w0","w1",
"w0","w0","w0","w0","w0","w0","w0","w0","w0","w0","w0","w0","w0","w0","w0","w0","w0","w0","w0","w0","w0","w0","w0","w0","w0","w0","w0","w0","w0","w0","w1"
        ] ,
        "mapdims" : { "x":31,"y":22 }
}