{
    "mapdata" : [
                 "0","0","0","0","E","0","0","0","0","0","0","0","0","0","0","0",
                 "0","1","1","1","1","1","1","1","1","1","1","1","1","1","1","0",
                 "0","0","1","1","1","1","1","1","0","0","0","1","1","1","1","0",
                 "0","0","1","1","1","1","1","1","0","0","0","0","0","0","1","0",
                 "0","0","0","0","1","0","0","0","0","U","I","0","0","0","1","0",
                 "0","U","I","0","1","0","0","0","0","J","K","0","0","0","0","0",
                 "0","J","K","0","1","0","0","0","0","0","0","0","0","0","0","0",
                 "0","0","0","0","1","0","0","0","0","0","0","0","0","0","0","0",
                 "0","0","0","1","1","1","1","1","1","1","0","0","0","0","0","0",
                 "0","0","1","1","1","1","1","1","1","1","1","1","1","1","1","0"
                ] ,
    "mapdims" : { "x":16,"y":10 }
}
