{
        "mapdata" : [

"wi6","wi6","wi6","wi6","wiy","l3", "l4", "l4", "l8", "w2", "w0", "w0", "w0", "w0", "w0", "w0", "w0", "w0", "w0", "w0", "w0", "w0", "w0", "w0", "w0", "w1", "fx", "fx", "fx", "fx", "fx",
"wim","wi6","wi6","wi6","wiy","l3", "l4", "l5", "w2", "w0", "w0", "w0", "w0", "w0", "w0", "w0", "w0", "w0", "w0", "w0", "w0", "w0", "w0", "w0", "w1", "fx", "fx", "fx", "fx", "fx", "fx",
"win","wil","wil","wil","wiy","l3", "l4", "l5", "w2", "w0", "w0", "w0", "w1", "f0", "f0", "f0", "f0", "w2", "w0", "w0", "w0", "w0", "w1", "f0", "f0", "f0", "f0", "f0", "f0", "f0", "f0",
"fi", "fi", "fi", "fi", "wix","l3", "l4", "l5", "f0", "w3", "w2", "w1", "f0", "f0", "f0", "f0", "f0", "f0", "f0", "f0", "f0", "w3", "f0", "f0", "fx", "fx", "fx", "fx", "fx", "f0", "fx",
"fi", "fi", "fi", "fi", "fi", "f3", "f3", "f3", "f0", "f0", "f0", "f0", "f0", "f0", "f0", "f0", "f0", "f0", "f0", "f0", "f0", "f0", "f0", "fx", "fx", "fx", "fx", "fx", "fx", "f0", "fx",
"fi", "fi", "fi", "fi", "fi", "f3", "f3", "f3", "f0", "f0", "f0", "f0", "f0", "f0", "f0", "f0", "f0", "f0", "f0", "f0", "f0", "fx", "fx", "fx", "fx", "fx", "fx", "fx", "fx", "f0", "s5",
"fe4","fi", "fi", "fi", "fi", "f3", "f3", "f3", "f0", "f0", "f0", "f0", "f0", "f0", "f0", "f0", "f0", "f0", "f0", "f0", "f0", "fx", "fx", "fx", "fx", "fx", "fx", "fx", "fx", "f0", "f0",
"fi", "fi", "fi", "fi", "fi", "f3", "f3", "f3", "f0", "f0", "f0", "f0", "f0", "f0", "f0", "f0", "f0", "f0", "f0", "f0", "f0", "fx", "fx", "fx", "fx", "fx", "fx", "fx", "fx", "f0", "f0",
"fi", "fi", "fi", "fi", "wia","l3", "l4", "l5", "f0", "f0", "f0", "f0", "f0", "f0", "f0", "f0", "f0", "f0", "f0", "f0", "f0", "fx", "fx", "fx", "fx", "fx", "fx", "fx", "fx", "fx", "f0",
"fi", "fi", "fi", "wiw","wio","l3", "l4", "l5", "f0", "f0", "f0", "f0", "f0", "f0", "f0", "f0", "f0", "f0", "f0", "f0", "f0", "fx", "fx", "fx", "fx", "fx", "fx", "fx", "fx", "fx", "s5",
"wic","wic","wic","wio","wir","l3", "l4", "l5", "f0", "f0", "f0", "f0", "f0", "f0", "f0", "f0", "f0", "f0", "f0", "f0", "w2", "w1", "fx", "fx", "fx", "fx", "fx", "fx", "fx", "fx", "f0",
"wi6","wi6","wi6","wir","wir","l3", "l4", "l5", "f0", "f0", "f0", "f0", "f0", "f0", "f0", "f0", "f0", "f0", "w2", "w0", "w0", "w0", "w1", "fx", "fx", "fx", "fx", "fx", "fx", "fx", "f0",
"wi6","wi6","wi6","wir","wir","l3", "l4", "l5", "f0", "f0", "f0", "f0", "f0", "f0", "f0", "f0", "f0", "f0", "w2", "w0", "w0", "w0", "w0", "w0", "w1", "fx", "fx", "fx", "fx", "fx", "f0",
"wi6","wi6","wi6","wir","wit","l3", "l4", "l5", "f0", "f0", "f0", "f0", "f0", "f0", "f0", "f0", "f0", "f0", "w2", "w0", "w0", "w0", "w0", "w0", "w0", "w0", "w1", "fx", "fx", "fx", "f0",
"wil","wil","wil","wit","fd", "l4", "l4", "l5", "f0", "f0", "f0", "f0", "f0", "f0", "f0", "f0", "f0", "w3", "w2", "w0", "w0", "w0", "w0", "w0", "w0", "w0", "w0", "w1", "fx", "fx", "s5",
"f0", "f0", "f0", "f0", "l3", "l4", "l4", "fb", "w2", "w1", "f0", "f0", "f0", "f0", "f0", "f0", "f0", "w2", "w0", "w0", "w0", "w0", "w0", "w0", "w0", "w0", "w1", "f0", "f0", "f0", "f0",
"f0", "f0", "f0", "f0", "l3", "l4", "l5", "w2", "w0", "w0", "w1", "f0", "f0", "f0", "f0", "f0", "w2", "w0", "w0", "w0", "w0", "w0", "w0", "w0", "w0", "w1", "f0", "f0", "f0", "f0", "f0",
"f0", "f0", "f0", "fd", "l4", "l4", "l5", "w2", "w0", "w0", "w0", "w1", "f0", "f0", "f0", "w2", "w0", "w0", "w0", "w0", "w0", "w0", "w0", "w0", "w0", "w1", "f0", "f0", "f0", "f0", "f0",
"f0", "f0", "f0", "l3", "l4", "l4", "fb", "w2", "w0", "w0", "w0", "w1", "f0", "w2", "w0", "w0", "w0", "w0", "w0", "w0", "w0", "w0", "w0", "w0", "w1", "f0", "f0", "f0", "f0", "f0", "f0",
"f0", "f0", "fd", "l4", "l4", "l5", "w2", "w0", "w0", "w0", "w0", "w0", "w0", "w0", "w0", "w0", "w0", "w0", "w0", "w0", "w0", "w0", "w0", "w1", "f0", "f0", "f0", "f0", "f0", "f0", "f0",
"fd", "l1", "l4", "l4", "l4", "l4", "fc", "w2", "w0", "w0", "w0", "w0", "w0", "w0", "w0", "w0", "w0", "w0", "w0", "w0", "w0", "w0", "w0", "w1", "f0", "f0", "f0", "f0", "f0", "f0", "f0",
"l3", "l4", "l4", "l4", "l4", "l4", "l5", "w2", "w0", "w0", "w0", "w0", "w0", "w0", "w0", "w0", "w0", "w0", "w0", "w0", "w0", "w0", "w0", "w1", "f0", "f0", "f0", "f0", "f0", "f0", "f0"

        ] ,
        "mapdims" : { "x":31,"y":22 },
        "npcs": [
                {
                        "type": 5,
                        "x": 2,
                        "y": 3,
                        "says": "Goblins! Attacking from the east!"
                },
                {
                        "type": 5,
                        "x": 2,
                        "y": 8,
                        "says": "We're being invaded!"
                },
                {
                        "type": 7,
                        "x": 12,
                        "y": 17,
                        "says": "Heeeeeelp!"
                },
                {
                        "type": 2,
                        "x": 11,
                        "y": 15,
                        "says": "Run for your lives!"
                },
                {
                        "type": 6,
                        "x": 24,
                        "y": 20,
                        "says": "DOOG. O.O"
                }
        ]
}
