{
        "mapdata" : [
"l4", "l4", "l4", "l5", "fx", "fx", "w2", "w0", "w0", "w0", "w0", "w0", "w0", "w0", "w0", "w0", "w1", "fd", "l4", "l4", "l7", "l7", "l7", "l7", "l7", "l7", "l7", "l4", "l4", "l4", "l4", 
"l4", "l4", "l4", "l5", "s0", "f0", "f0", "f0", "f0", "f0", "f0", "f0", "f0", "f0", "f0", "w2", "w1", "l6", "l7", "fb", "w3", "f0", "w2", "w0", "w1", "f0", "w3", "fa", "l4", "l4", "l4", 
"l4", "l4", "l4", "fb", "f0", "f0", "f0", "f0", "w2", "w0", "w0", "w1", "f0", "f0", "f0", "f0", "f0", "f0", "f0", "f0", "f0", "f0", "f0", "w2", "w1", "f0", "f0", "w3", "l6", "l4", "l4", 
"l4", "l4", "l5", "w2", "w0", "w0", "w0", "w0", "w0", "w0", "w0", "w0", "w0", "w0", "w1", "f0", "w2", "w0", "w1", "f0", "f0", "f0", "f0", "w2", "w1", "f0", "f0", "f0", "f0", "l6", "l4", 
"l4", "l4", "l4", "l4", "fc", "fd", "l1", "l1", "l1", "l1", "l1", "l2", "w2", "w0", "w0", "w0", "w0", "w0", "w0", "w0", "w1", "f0", "f0", "w3", "f0", "f0", "w3", "f0", "f0", "w3", "l3", 
"l4", "l4", "l4", "l7", "l7", "l7", "l7", "l7", "l4", "l4", "l4", "l4", "l1", "fc", "w2", "w0", "w1", "w2", "w0", "w0", "w1", "f0", "f0", "f0", "f0", "w2", "w0", "w1", "f0", "f0", "l3", 
"l4", "l4", "fb", "w3", "f0", "f0", "f0", "w3", "fa", "l7", "l4", "l4", "l4", "l5", "w2", "w1", "f0", "f0", "w2", "w0", "w0", "w1", "f0", "f0", "w2", "w0", "w0", "w1", "f0", "f0", "fa", 
"l4", "l5", "w2", "w1", "f0", "f0", "f0", "f0", "f0", "f0", "fa", "l7", "l7", "l8", "w3", "f0", "f0", "f0", "f0", "f0", "w2", "w0", "w0", "w0", "w0", "w1", "f0", "f0", "f0", "w2", "w0", 
"l4", "fb", "w3", "f0", "f0", "f0", "f0", "f0", "f0", "f0", "f0", "w2", "w0", "w0", "w1", "f0", "f0", "f0", "w3", "f0", "f0", "w2", "w0", "w0", "w1", "f0", "f0", "f0", "w2", "w1", "fd", 
"l5", "w3", "f0", "f0", "w3", "f0", "f1", "f2", "f0", "f0", "f0", "f0", "w2", "w1", "f0", "f0", "f0", "f0", "f0", "w3", "f0", "f0", "w2", "w1", "s0", "f0", "f0", "w2", "w0", "w1", "l6", 
"l5", "f0", "f0", "f0", "s0", "f0", "f0", "f0", "f0", "w3", "f0", "f0", "f0", "f0", "f0", "f0", "f0", "s0", "f0", "f0", "f0", "w2", "w1", "f0", "f0", "f0", "f0", "f0", "w2", "w0", "w0", 
"l4", "fc", "f0", "w3", "f0", "f1", "f2", "f0", "f0", "f0", "f0", "f0", "f0", "f0", "f0", "f0", "f0", "f0", "f0", "f0", "f0", "f0", "w3", "f0", "f0", "f0", "f0", "w2", "w0", "w0", "w0", 
"l4", "l4", "fc", "f0", "f0", "f0", "f0", "f0", "w2", "w1", "f0", "f0", "f0", "f0", "f0", "f0", "f0", "f0", "f0", "f0", "f0", "w2", "w1", "f0", "f0", "f0", "w2", "w0", "w1", "f0", "fd", 
"l4", "l7", "l8", "f0", "f0", "f0", "f0", "f0", "w2", "w0", "w1", "f0", "f0", "f0", "f0", "f0", "f0", "f0", "f0", "f0", "f0", "w2", "w0", "w1", "f0", "f0", "w2", "w0", "w1", "f0", "l3", 
"l5", "f0", "f0", "f0", "f0", "w2", "w0", "w0", "w0", "w0", "w0", "w1", "f0", "f0", "f0", "f0", "w2", "w0", "w1", "f0", "f0", "w2", "w0", "w0", "w1", "f0", "f0", "w2", "w0", "w1", "l3", 
"l5", "f0", "f0", "f0", "f0", "f0", "f0", "f0", "f0", "w2", "w0", "w0", "w1", "f0", "f0", "l0", "l1", "fc", "w2", "w1", "f0", "f0", "w2", "w0", "w1", "f0", "f0", "f0", "w2", "w1", "l3", 
"l4", "fc", "f0", "f0", "f0", "f0", "f0", "f0", "f0", "w2", "w0", "w0", "w0", "w0", "w1", "l6", "l7", "l4", "l2", "w3", "f0", "f0", "w2", "w0", "w1", "f0", "f0", "f0", "f0", "l0", "l4", 
"l4", "l5", "w2", "w1", "f0", "f0", "f0", "f0", "w2", "w0", "w0", "w0", "w0", "w0", "w1", "c0", "c1", "l3", "l5", "w2", "w1", "f0", "f0", "f0", "w2", "w1", "f0", "f0", "f0", "l6", "l4", 
"l4", "l4", "fc", "w2", "w1", "f0", "f0", "f0", "f0", "f0", "f0", "f0", "f0", "w2", "w1", "c2", "c3", "l3", "f3", "fe", "w2", "w1", "f0", "f0", "f0", "w2", "w0", "w1", "f0", "f0", "l3", 
"l4", "l4", "l4", "l5", "w2", "w0", "w1", "f0", "f0", "f0", "f0", "f0", "f0", "f0", "w2", "w0", "w1", "l3", "l5", "f0", "w2", "w0", "w0", "w1", "f0", "f0", "f0", "f0", "f0", "f0", "l3", 
"l4", "l4", "l4", "l4", "l1", "l1", "l1", "l1", "l1", "l1", "l1", "l1", "l2", "f0", "f0", "f0", "f0", "l3", "l5", "f0", "f0", "w2", "w0", "w0", "w1", "f0", "f0", "f0", "fd", "l1", "l4", 
"l4", "l4", "l4", "l4", "l4", "l4", "l4", "l4", "l4", "l4", "l4", "l4", "l4", "l1", "fc", "f0", "f0", "f3", "f3", "f0", "fd", "l1", "l1", "l1", "l1", "l1", "l1", "l1", "l4", "l4", "l4", 
"l4", "l4", "l4", "l4", "l4", "l4", "l4", "l4", "l4", "l4", "l4", "l4", "l4", "l4", "l4", "l1", "l1", "l4", "l4", "l1", "l4", "l4", "l4", "l4", "l4", "l4", "l4", "l4", "l4", "l4", "l4"
        ] ,
        "mapdims" : { "x":31,"y":22 },
        "npcs": [
                {
                        "type": 2,
                        "x": 19,
                        "y": 20,
                        "says": "The drawbridge has collapsed!"
                },
                {
                        "type": 4,
                        "x": 17,
                        "y": 21,
                        "says": "You must find the root of this evil!"
                },
                {
                        "type": 5,
                        "x": 13,
                        "y": 20,
                        "says": "We're counting on you! Good luck!"
                },
                {
                        "type": 7,
                        "x": 25,
                        "y": 3,
                        "says": "Save us!"
                }
        ]
}