{
    "mapdata" : [
                 "w0","w0","w0","w0","w0","w0","w0","w0","w0","w0","w0","w0","w0","w0","w0","w0","w0","w1","f0","f0","w2","w0","w1","l3","l4","l4","l4","l4","l4","l4","l4",
                 "w0","w0","w0","w0","w0","w0","w0","w0","w0","w0","w0","w0","w0","w0","w0","w0","w0","w1","f0","f0","w2","w1","f0","l3","l4","l4","l4","l4","l7","l7","l4",
                 "w0","w0","w0","w0","w0","w0","w0","w0","w0","w0","w0","w0","w0","w0","w0","w0","w0","w1","c0","c1","w2","w1","l0","l4","l4","l4","l7","l8","f0","f0","l3",
                 "w0","w0","w0","w0","w0","w0","w0","w0","w0","w0","w0","w0","w0","w0","w0","w0","w1","s1","c2","c3","w3","l0","l4","l4","l4","l8","w3","f0","f0","f0","l3",
                 "w0","w0","w0","w0","w0","w0","w0","w0","w0","w1","w3","f0","f0","w2","w0","w0","w1","f0","f0","f0","f0","l3","l4","l4","l5","f0","f0","f0","w3","f0","l3",
                 "w0","w0","w0","w0","w0","w0","w0","w0","w0","w1","f0","f0","f0","f0","w2","w0","w1","f0","f0","w3","f0","l3","l4","l7","l8","f0","f0","f0","f0","f0","l3",
                 "w0","w0","w0","w0","w0","w1","f0","w3","f0","f0","f0","f0","w3","f0","w2","w0","w1","f0","f0","f0","f0","f3","f3","f0","f0","f0","f0","f0","f0","f0","l3",
                 "w0","w0","w0","w0","w0","w1","f0","f0","f0","f0","f0","f0","f0","f0","w2","w0","w1","f0","f0","f0","f0","l3","l4","l1","l2","f0","f0","l0","l2","f0","l3",
                 "w0","w0","w1","w3","f0","f0","f0","f0","f0","w3","f0","w2","w1","f0","f0","f0","w2","w1","f0","f0","l0","l4","l4","l4","l5","w3","l0","l4","l8","f0","l3",
                 "w0","w0","w1","f0","f0","f0","f0","f0","f0","f0","w2","w1","f0","f0","f0","f0","w2","w0","w0","w1","l6","l7","l4","l4","l4","l1","l4","l8","f0","f0","l3",
                 "w0","w1","f0","f0","f0","w2","w0","w1","f0","w2","w0","w1","f0","f0","w2","w0","w1","f0","w2","w0","w0","w1","l3","l4","l4","l4","l8","f0","s1","f0","l3",
                 "w1","f0","s1","f0","f0","w2","w0","w0","w1","w2","w1","f0","f0","f0","w3","f0","f0","w3","f0","f0","w2","w1","l3","l4","l4","fb","w3","f0","f0","f0","l3",
                 "w1","w3","f0","f0","f0","f0","f0","w2","w0","w0","w1","f0","f0","w2","w1","f0","f0","f0","f0","f0","f0","f0","l6","l4","l8","f0","f0","f0","f0","f0","l3",
                 "w1","f0","f0","f0","f0","f0","f0","w2","w0","w0","w0","w1","f0","f0","f0","f0","f0","f0","f0","w3","f0","f0","f0","f3","f3","f0","f0","f0","f0","f0","l3",
                 "w1","f0","f0","f0","w3","f0","f0","f0","w2","w0","w0","w0","w0","w1","f0","w3","f0","f0","f0","f0","f0","w3","l0","l4","l5","f0","f0","f0","w3","l0","l4",
                 "w1","f0","w3","f0","f0","f0","f0","f0","f0","f0","f0","w2","w0","w0","w1","f0","f0","f0","f0","f0","f0","f0","l3","l4","l4","l2","f0","f0","l0","l4","l4",
                 "w1","f0","f0","f0","f0","f0","f0","w3","f0","f0","f0","f0","w2","w0","w1","l0","l2","f0","w3","f0","s1","l0","l4","l4","l4","l8","f0","l0","l4","l4","l4",
                 "w1","f0","f0","f0","f0","f0","f0","f0","f0","f0","f0","f0","f0","l0","l1","l4","l5","f0","f0","l0","l1","l4","l4","l4","l8","f0","f0","l3","l4","l4","l4",
                 "w0","w1","w3","f0","f0","f0","f0","f0","f0","f0","w3","f0","f0","l6","l4","l4","l4","l1","l1","l4","l4","l4","l4","l8","f0","f0","w3","l3","l4","l4","l4",
                 "w0","w1","f0","f0","f0","f0","f0","f0","f0","f0","f0","f0","w2","w1","l3","l4","l4","l4","l4","l7","l7","l7","l8","f0","f0","f0","l0","l4","l4","l4","l4",
                 "w0","w1","f0","f0","f0","f0","f0","f0","w3","f0","w2","w0","w0","w1","l6","l4","l4","l7","l8","f0","w3","f0","w2","w0","w1","f0","l3","l4","l4","l4","l4",
                 "w0","w0","w1","f0","fe","f0","w2","w0","w0","w0","w0","w0","w0","w0","w1","l3","l5","w2","w0","w0","w0","w0","w0","w0","w0","w1","l3","l4","l4","l4","l4"
                ] ,
    "mapdims" : { "x":31,"y":22 }
}
