{
"mapdata" : [
"l4","l4","l4","l4","l4","l5","w2","w0","w0","w0","w0","w0","w0","w0","w0","w0","w0","w0","w0","w0","w0","w0","w0","w0","w0","w0","w0","w0","w0","w0","w0",
"l4","l4","l4","l4","l4","l8","s0","f0","f0","f0","f0","f0","w3","f0","f0","w3","f0","f0","f0","f0","f0","f0","f0","s0","f0","f0","w2","w0","w0","w0","w0",
"l4","l4","l4","l4","l8","f0","f0","f0","ff","fg","f0","f0","f0","f0","w2","w1","f0","w3","f0","f0","f0","w3","f0","f0","f0","f0","f0","w2","w0","w0","w0",
"l4","l4","l4","l5","f0","f0","f0","ff","f4","f4","f7","f7","fg","w2","w0","w1","f0","f0","w3","f0","f0","f0","f0","w3","f0","f0","f0","f0","w2","w0","w0",
"l4","l4","l4","l8","f0","f0","f0","f5","f4","f4","f4","f4","fh","f0","w3","f0","f0","f0","w2","w1","f0","f0","f0","f0","f0","f0","f0","f0","w2","w0","w0",
"l4","l4","l8","f0","f0","f0","ff","f4","f4","f4","f4","f6","f0","f0","w2","w1","f0","f0","f0","w3","w3","w2","w0","w0","w1","f0","f0","f0","w2","w0","w0",
"l4","l5","f0","f0","f0","w3","f9","f8","f4","f4","f8","fh","f0","f0","w3","f0","f0","f0","f0","w2","w1","f0","w2","w0","w0","w0","w1","f0","w2","w0","w0",
"l4","l5","f0","f0","w2","w1","f0","f0","f9","fh","f0","w2","w0","w0","w0","w1","f0","w2","w0","w0","w0","w1","w3","f0","f0","f0","f0","f0","w2","w0","w0",
"l4","l8","f0","f0","w2","w1","f0","f0","w2","w0","w0","w0","w1","f0","f0","f0","f0","w2","w0","w1","f0","f0","f0","f0","f0","f0","f0","f0","f0","w2","w0",
"l8","f0","f0","f0","w2","w1","f0","f0","f0","f0","f0","f0","f0","f0","f0","w2","w0","w1","f0","f0","f0","l0","l1","l1","l1","fc","f0","f0","f0","w2","w0",
"fx","f0","f0","fd","l4","l2","f0","f0","f0","f0","f0","f0","f0","s0","f0","w2","w0","w1","f0","f0","l0","l4","l4","l7","l7","l4","fc","f0","f0","f0","w2",
"fx","fd","l1","l4","l4","l4","l1","l2","f0","w3","f0","f0","w2","w0","w0","w0","w0","w0","w1","f0","l3","l4","fb","w2","w1","l6","l4","fc","f0","f0","w2",
"l1","l4","l4","l4","l4","l4","l4","l4","l1","l1","l1","l1","l1","l1","l1","l1","l2","w3","f0","f0","f3","f3","f0","w2","w0","w1","l3","l5","f0","f0","w2",
"l4","l4","l4","l4","l4","l4","l4","l4","l4","l4","l4","l4","l4","l4","l4","l7","l4","l1","l1","l1","l7","l8","f0","f0","w2","w1","l3","l5","f0","s0","w2",
"l4","l4","l4","l4","l4","l4","l4","l4","l4","l4","l7","l7","l7","l7","l8","w3","l6","l7","l7","l8","w3","f0","f0","f0","w2","w1","l3","l5","f0","f0","w2",
"l4","l4","l4","l4","l4","l4","l4","l7","l7","l8","f0","f0","f0","f0","f0","f0","w3","w2","w0","w0","w1","f0","w3","f0","f0","f0","l3","l5","f0","f0","fd",
"l4","l4","l4","l4","l4","l7","l8","f0","f0","f0","f0","f0","f0","w3","f0","f0","f0","w2","w0","w1","f0","f0","f0","f0","f0","f0","f3","f3","f0","f0","l3",
"l4","l4","l4","l4","l8","w3","f0","w3","f0","f0","f0","w2","w1","f0","f0","f0","w2","w0","w0","w1","f0","w3","f0","f0","w3","f0","l3","l5","f0","fd","l4",
"l4","l4","l4","l5","w3","f0","f0","f0","f0","f0","w3","w2","w0","w1","f0","f0","f0","f0","w3","f0","f0","f0","f0","f0","f0","l0","l4","l4","fc","l6","l4",
"l4","l4","l4","l5","f0","f0","f0","f0","f0","w2","w0","w0","w0","w1","f0","f0","f0","f0","f0","f0","f0","f0","w3","f0","fd","l4","l4","l4","l4","l1","l4",
"l4","l4","l4","l5","f0","f0","f0","f0","w2","w0","w0","w0","w1","w2","w1","f0","f0","f0","f0","f0","f0","f0","f0","fd","l4","l4","l4","l4","l4","l4","l4",
"l4","l4","l4","l5","fe","f0","f0","w2","w0","w0","w0","w0","w0","w1","w2","w1","f0","fd","l1","l1","l1","l1","l1","l4","l4","l4","l4","l4","l4","l4","l4"
] ,
        "mapdims" : { "x":31,"y":22 },

        "npcs": [
                {
                        "type": 4,
                        "x": 6,
                        "y": 20,
                        "says": "What are we to do?"
                },
                {
                        "type": 5,
                        "x": 5,
                        "y": 18,
                        "says": "There's a castle to the north east, maybe they will know more about this plague!"
                },
                {
                        "type": 5,
                        "x": 18,
                        "y": 10,
                        "says": "I'm scared of goblins!"
                },
                {
                        "type": 4,
                        "x": 1,
                        "y": 9,
                        "says": "This way! Hurry!"
                }
        ]
}
