{
        "mapdata" : [
"w0","w0","w1","c0","c1","w2","w0","w0","w0","w0","w0","w0","w0","w0","w1","l3","l5","w2","w0","w0","w0","w0","w0","w0","w0","w1","l3","l4","l4","l4","l4",
"w0","w1","f0","c2","c3","f0","f0","w2","w0","w0","w1","f0","f0","f0","l0","l7","l8","w2","w0","w0","w1","f0","f0","w2","w0","w1","l3","l4","l4","l4","l4",
"w0","w1","f0","s1","ff","fg","f0","w2","w0","w1","f0","f0","l0","l1","l5","f0","f0","w3","f0","f0","f0","f0","s1","w2","w0","w1","l3","l4","l4","l4","l4",
"w1","f0","ff","f7","f4","f6","f0","f0","w2","w0","w1","f0","l3","l4","l5","f0","w2","w1","f0","w3","f0","f0","f0","w2","w1","l0","l4","l4","l4","l4","l4",
"w1","f0","f5","f4","f4","f4","fg","w2","w0","w0","w1","f0","l3","l4","l8","f0","w2","w1","f0","w2","w1","f0","f0","f0","w3","l3","l4","l4","l4","l4","l4",
"w0","w1","f9","f4","f4","f4","fh","f0","w2","w0","w1","f0","l3","l5","f0","w2","w0","w1","f0","w2","w0","w1","f0","f0","l0","l4","l4","l4","l4","l4","l4",
"w0","w1","f0","f5","f4","f6","s1","f0","f0","w2","w1","f0","f3","f3","f0","w2","w1","f0","f0","w2","w0","w1","f0","l0","l4","l4","l4","l4","l4","l4","l4",
"w1","f0","s1","f5","f4","f4","f7","f7","fg","w2","w1","f0","l3","l5","f0","w3","f0","f0","l0","l1","l2","w3","f0","l3","l4","l4","l7","l4","l4","l4","l4",
"w0","w1","ff","f4","f4","f4","f4","f8","fh","f0","w3","f0","l3","l4","fc","f0","f0","l0","l4","l7","l8","f0","f0","l3","l4","l8","f0","fa","l7","l4","l4",
"w0","w1","f9","f8","f4","f4","fh","f0","f0","w2","w1","f0","l6","l4","l4","l1","l1","l4","l5","f0","f0","f0","l0","l4","l8","f0","f0","f0","f0","l6","l7",
"w1","f0","f0","f0","f5","f6","f0","f0","f0","w2","w1","f0","f0","l6","l7","l7","l7","l4","l5","f0","f0","f0","l3","l5","f0","f0","f0","f0","f0","f0","fe",
"w1","f0","f0","f0","f9","fh","f0","w2","w0","w0","w0","w1","f0","f0","f0","f0","f0","l6","l4","l2","f0","l0","l4","l5","f0","w3","f0","f0","f0","f0","f0",
"w0","w1","f0","f0","f0","f0","f0","w2","w1","f0","f0","f0","f0","w3","f0","f0","f0","f0","fa","l8","f0","l3","l4","l5","f0","f0","f0","f0","f0","f0","f0",
"w0","w0","w0","w1","f0","f0","w2","w1","f0","f0","w2","w1","f0","f0","f0","w3","w2","w0","w0","w1","f0","l3","l4","l8","f0","f0","f0","f0","f0","f0","l0",
"w0","w0","w0","w1","f0","w2","w1","f0","f0","w2","w0","w0","w0","w0","w0","w0","w1","f0","f0","f0","f0","l3","l5","f0","f0","w2","w0","w1","l0","l1","l4",
"w0","w0","w1","f0","f0","f0","f0","f0","w2","w0","w0","w0","w1","f0","f0","f0","f0","f0","f0","f0","w3","l3","fb","f0","w2","w0","w1","fd","l4","l4","l4",
"w1","f0","f0","f0","f0","f0","f0","w2","w0","w0","w0","w1","f0","f0","w2","w0","w0","w0","w0","w0","w1","l3","fc","f0","w2","w1","l0","l4","l4","l4","l4",
"w1","f0","f0","f0","f0","f0","w2","w0","w0","w0","w1","f0","f0","w2","w1","f0","f0","f0","f0","f0","f0","l6","l8","f0","fd","l1","l4","l4","l4","l4","l4",
"l4","l2","f0","f0","f0","f0","f0","f0","w2","w0","w1","f0","w2","w1","f0","f0","f0","f0","f0","w3","f0","f0","f0","f0","l3","l4","l4","l4","l4","l4","l4",
"l4","l4","fc","f0","f0","f0","f0","f0","f0","f0","w3","f0","w2","w1","s0","f0","f0","f0","f0","f0","f0","fd","l1","l1","l4","l4","l4","l4","l4","l4","l4",
"l4","l4","l4","l1","l1","l1","l1","l1","fc","w2","w1","f0","f0","f0","f0","f0","f0","f0","f0","f0","fd","l4","l4","l4","l4","l4","l4","l4","l4","l4","l4",
"l4","l4","l4","l4","l4","l4","l4","l4","l4","l1","l1","l1","l1","l1","l1","l1","l1","l1","l1","l1","l4","l4","l4","l4","l4","l4","l4","l4","l4","l4","l4"
        ] ,
        "mapdims" : { "x":31,"y":22 },
        "npcs": [
                {
                        "type": 2,
                        "x": 25,
                        "y": 13,
                        "says": "The castle lies ahead through the forest. Take care!"
                },
                {
                        "type": 4,
                        "x": 11,
                        "y": 19,
                        "says": "Lizardmen! Run!"
                }
        ]
}
